compo|components|around
laun|launch|languageserver.ccls
|createSpell|languageserver.ccls
lear|learnSpell|languageserver.ccls
cre|createTarget|languageserver.ccls
getHitBySpell|getHitBySpell|languageserver.ccls
As|ASpell|around
set|setTitle|languageserver.ccls
setT|setTitle|languageserver.ccls
lau|launch|languageserver.ccls
launchSpell|launchSpell|languageserver.ccls
forget|forgetSpell|languageserver.ccls
Muta|MutantStack|languageserver.ccls
convert|convert|languageserver.ccls
m|makeForm|languageserver.ccls
tar|target|around
inclu|include|languageserver.ccls
exe|executeForm|languageserver.ccls
be|beSigned|languageserver.ccls
c|clone|languageserver.ccls
use|use|languageserver.ccls
lear|learnMateria|languageserver.ccls
une|unequip|languageserver.ccls
eq|equip|languageserver.ccls
includ|include|languageserver.ccls
Anim|Animal|around
att|attack|languageserver.ccls
_hitPo|_hitPoints|languageserver.ccls
be|beRepaired|languageserver.ccls
Clap|ClapTrap|around
attack|attack|languageserver.ccls
get|getX|languageserver.ccls
x|x|languageserver.ccls
min|min|languageserver.ccls
operator|operator|languageserver.ccls
|->getRawBits|languageserver.ccls
compl|complain|languageserver.ccls
replace|replace|languageserver.ccls
Human|HumanB|languageserver.ccls
Zom|Zombie.hpp"|languageserver.ccls
itera|const_iterator|languageserver.ccls
tm_mo|tm_mon|languageserver.ccls
get|getNbWithdrawals|languageserver.ccls
typ|types.h>|languageserver.ccls
add|addContact|languageserver.ccls
ignore|ignore|languageserver.ccls
cle|clear|languageserver.ccls
Phone|PhoneBook.hpp"|languageserver.ccls